000000000000000000000000000000000000000000000000000000000000
055555555555555555553555555355555553555555535555555355555550
055555555555555555553555555355555553555555535555555355555550
055555555555555555553555555355555553555555535555555355555550
055555555555555555553555555355555553555555535555555355555560
033333333335555555555555555555555555555555555555555555555670
055555555555555555555555555555555555555555555555555555556780
055555555555555555555555555555555555555555555555555555567890
055555555555555555555555555555555555555555555555555555567890
055555555555555555555555555555555555555555555555555555567890
055555555555555555555555555555555555555555555555555555556780
033333333335555555555555555555555555555555555555555555555670
055555555555555555555355555555555555555555555555555555555560
055555555555555555553335555555555555555555555555555555555550
055555555555555555555355555555555555553555555555555555555550
055555555555555555555555555555555555533355555555555555555550
055555555555555555555555555555555555553555555555555555555550
033333333335555555555555555555555555555555555555555555555550
055555555555555555555555555555555555555555555555555555555550
055555555555555555555555555555555555555555555555555555550660
055555555555555555555555355555555555555555555555555555550660
055555555555555555555553335555555555555555555555555555550770
055555555555555555555555355555555555555555555555555555550770
055555555555555555555555555555555555555555555555555555550880
033333333335555555555555555555555555535555555555555566000880
055555555555555555555555555555555555333555555555555667788990
055555555555555555555555555555555555535555555555555667788990
055555555555555555555555555555555555555555555555555566000000
055555555555555555555555555555555555555555555555555555555550
055555555555555555555555555555555555555555555555555555555550
055555555555555555555555555555555555555555555555555555555550
033333333335555555535555553555555355555535555553555553555550
055555555555555555535555553555555355555535555553555553555550
055555555555555555535555553555555355555535555553555553555550
055555555555555555535555553555555355555535555553555553555550
000000000000000000000000000000000000000000000000000000000000